11111111111111111
100000000000P0001
1C0C00000000C0001
1000000000C000001
100CC00C0000E0C01
11111111111111111