111111111111
1E1000101001
111P00000001
1010000C0101
111111111111