11111111111111111
1P000000000000001
1C000000000000001
1C000000000000001
1C00000001000E001
11111111111111111