111111111111111
1CCCCC0000000E1
1010001111CCC01
1000CC010000001
1P0000000CCC001
111111111111111