1111111111111111111
1E00000000000CC0C01
100000000C001111111
10011C000C0000CC001
1000CC00CC1000000P1
1111111111111111111