1111111111111111111
1CCCCCCCC0C00000001
100100111CCC0100001
1001001000001000001
10010C1C0C0C0000001
10010C1C0C0C0001101
10010C1C1C0C0011101
10010C1C100C0111001
10010C1C1P0C00CC101
10000C0C0C0C0111001
10000C0C0C0C00000E1
1111111111111111111
