1111111111111111
1000000000000E01
10000000CC000C01
10000000000P0P01
1111111111111111