1111111111111
1EC000C0000C1
1010101C10101
1010101C10101
1P00C0C0000C1
1111111111111