11111111111111111111111111
11111111111111111111111111
10000000000000000E00P00C01
11111111111111111111111111
